....#......#
...##.#.####
..##.......#
..#....###.#
.....@.#p..#
..##e.#.#..#
...#..#..###
###########

