..#.........#
#.....p#.a###
....##......#
...#......#.#
..a...@#.e..#
...##...##..#
....#..#....#
#############
..#.......#
..e.....##
