...#......#
..##.#.####
.##.......#
.#........#
....@..p..#
.##..###..#
...a.#....#
.##e#######
.#......##
.#.....##
