....@pa....#
....#......#
.....p....##
...........#
...........#
#..........#
.....e..#..#
############
