...#......#
..##.#.####
.##.......#
.#....###.#
....@.#p..#
.##e.#.#..#
..#..#..###
.##.##.#.##
.#......##
.#.....##
