...#......#
..##.#.####
.##..e....#
.#........#
...a@..p..#
.##.####..#
..#..#....#
.##.##.#.##
.#......##
.#.....##
