...#......#
..##.#.####
.##..e....#
.#........#
....@..p..#
.##..###..#
..#..#....#
.##.##.#.##
.#......##
.#.....##
