....@......
...........
...........
...........
...........
...........
.....e.....
###########
