...#......#
..##.#.####
.##.......#
.#........#
....@..p..#
.##...##..#
..#..#....#
.##.#..#.##
.#.......#
.e.....##
