...........#
..##p#.###.#
.##..e.....#
.#.........#
a...@..p...#
.##.#.##...#
..#.#......#
.##.##.#.###
############
.#.....##
